111111111111111111111
10000000X0000000000X1
1000000000C000E00P001
100X0C00000000C0000X1
111111111111111111111
